Backgrounds/Planets
00000000000000000000000000000000
vvvvvvvvvvvvvvvvvvvvvvvvvvvvvvvv
v000000000000000000000000000000v
v000000000000000000000000000000v
v00000000000000kk00000000000000v
v00000000000000kk00000000000000v
v00000000000000kk00000000000000v
v00000kkk000000kk000000kkk00000v
v000000k0000000000000000k000000v
v000000000000000000000000000000v
v000000000000000000000000000000v
v000000k0000000000000000k000000v
v00000kkk000000kk000000kkk00000v
v00000000000000kk00000000000000v
v00000000000000kk00000000000000v
v00000000000000kk00000000000000v
v000000000000000000000000000000v
v000000000000000000000000000000v
vvvvvvvvvvvvvvvvvvvvvvvvvvvvvvvv