Backgrounds/Planets
00000000000000000000000000000000
vvvvvvvvvvvvvvvvvvvvvvvvvvvvvvvv
v000000000000000000000000000000v
v000000000000000000000000000000v
v0000k0k00k0k000000k0k00k0k0000v
v00000k00k0k00000000k0k00k00000v
v0000k0k00k0k000000k0k00k0k0000v
v000000000000000000000000000000v
v00000000kkkkkkkkkkkkkk00000000v
v000000000000000000000000000000v
v000000000000000000000000000000v
v00000000kkkkkkkkkkkkkk00000000v
v000000000000000000000000000000v
v0000k0k00k0k000000k0k00k0k0000v
v00000k00k0k00000000k0k00k00000v
v0000k0k00k0k000000k0k00k0k0000v
v000000000000000000000000000000v
v000000000000000000000000000000v
vvvvvvvvvvvvvvvvvvvvvvvvvvvvvvvv