00000000000000000000000000000000
xxxxxxxxxxxxxxxxxxxxxxxxxxxxxxxx
x00000000000000ss00000000000000x
x00000000000000ss00000000000000x
x00000000000000ss00000000000000x
x0000bbb0000000000000000nnn0000x
x0000b00000000000000000000n0000x
x0000b00000000000000000000n0000x
x00000000s000000000000s00000000x
xsss00000s000000000000s00000sssx
xsss00000s000000000000s00000sssx
x00000000s000000000000s00000000x
x0000a00000000000000000000m0000x
x0000a00000000000000000000m0000x
x0000aaa0000000000000000mmm0000x
x00000000000000ss00000000000000x
x00000000000000ss00000000000000x
x00000000000000ss00000000000000x
xxxxxxxxxxxxxxxxxxxxxxxxxxxxxxxx