00000000000000000000000000000000
bbbbbbbbbbbbbbbbbbbbbbbbbbbbbbbb
b000000000000000000000000000000b
b000000000000000000000000000000b
b00000000000000000000b000000000b
b00000000000000000000b000000000b
b0000b0000000000000bbbbb0000000b
b0000b000000000000000b000000000b
b00bbbbb0000000000000b000000000b
b0000b0000000000000000000000000b
b0000b0000000000000000000000000b
b000000000000000000000000000000b
b000000000000000000000000000000b
b000000000000000000000000000000b
b000000000000000000000000000000b
b000000000000000000000000000000b
b000000000000000000000000000000b
b000000000000000000000000000000b
bbbbbbbbbbbbbbbbbbbbbbbbbbbbbbbb